N                  
O =
SO
..
/..



1234567111111
10111 000N1
11111111111

















