NO ./Assets/textures/brushed-metal-north.xpm
SO ./Assets/textures/brushed-metal-south.xpm
WE ./Assets/textures/brushed-metal-west.xpm
EA ./Assets/textures/brushed-metal-east.xpm

F 0,0,0
C 105,104,101

11111111111111111111111111111111111111111111111111111111111
10000000000000000000000000000000000000000000000000000000001
10000111111000000000110000000000000000010000000000000000001
1
1
1
1
1
1
1
1
1
1
1
1
1
1000001111
1111111