NO ./Assets/textures/Brick_Wall_Cracked.xpm
SO ./Assets/textures/Brick_wall.xpm
WE ./Assets/textures/Green_Wall_Rock.xpm
EA ./Assets/textures/Rocky_Road.xpm

F 220,100,0
C 225,30,0


        1111111111111111111111111
        1000000000110000000000001
        1011000001110000010000001
        1001000000000000001000001
111111111011000001110000000000001
100000000011000001110111111111111
11110111111111011100000010001
11110111111111011101010010001
11000000110101011100000010001
100N0000000000000000000000001
10000000000000001101010010001
11000001110101011111011110001111
11110111 1110101 101111010001
11111111 1111111 111111111111