NO ./assets/textures/brushed-metal-north.xpm
SO ./assets/textures/brushed-metal-south.xpm
WE ./assets/textures/brushed-metal-west.xpm
EA ./assets/textures/brushed-metal-east.xpm

F 1,1,255
C 1,1,1

                   1111111111111
        111111111110000000000001
        1000000000110000001000001
        1011000001110000010100001
        1001000000000000001000001
11111111011000001110000000000001
100000000011000001110112111111111
11110111111111011100000010001
11110121111111011101210010001
11000000110101011100000010001
10000000000000000000000000001
1E000000000000000000000000001
10000000000000000000000000001
10000000000000001101010010001
11000001110101011111011110001111
11110111 1110101 101111010001
 1111111 1111111 11111111111